1111111111111111
10010000000000C1
100C00E011111001
1P00100000000001
1111111111111111