1111111111111111111
10010000000000000C1
100C00E011111111101
1P00100000000001101
1111111111111111111